###################
#........#........#
#.##.###.#.###.##.#
#.................#
#.##.#.#####.#.##.#
#....#...#...#....#
####.###.#.###.####
####.#..+.+..#.####
####.#.##0##.#.####
.......#123#.......
####.#.#####.#.####
####.#.......#.####
####.###.#.###.####
#....#...#...#....#
#.##.#.#####.#.##.#
#.....+..@..+.....#
#.##.###.#.###.##.#
#........#........#
###################