###################
#........#........#
#.##.###.#.###.##.#
#........@........#
##.#.#.#####.#.#.##
##...#...#...#...##
####.###.#.###.####
#....#..+.+..#....#
#.##.#.#####.#.##.#
.......#321#.......
#.##.#.##0##.#.##.#
#.................#
####.##.###.##.####
####....###....####
####.#.#####.#.####
#.....+.....+.....#
#.##.###.#.###.##.#
#........#........#
###################